RDBBDBRRDBDDDRBRDDRDDDDBDDDRDDDDDRBDJD
DDPBDJDRDBDDDBBBDDBDRDDDDRDDRDRDDDBDBR
DDDDBDDRJDDRDDDDBDDDDDRDBBRDDDDDDDBDBB
JDBDDBRBRDDRDDDDBDDDRDDDDDDRDRRDDDDDDB
RDBDDDBDDRDBBDDRDBBJDDDDDDDRDRRDDDDDDB
RRDDRDDDDBDDDRDDDDDDRDRRDDDDDDRDDJBBDD
DDRDBBDDRDRRDDDBDDDDRDRRDDDDDDBDDRDBDR
DDBDDDJDDDDDDJDRDDBBRDDRDBDBRDDBRDDJDR
RDRDDDDBDBBDDJDRDDBBRDDRDDJDBDDDBDDRDB
DRDBBDDDDDRRBRDDJDBDBRDDBRDDDBRDDJDRDD
BDBBDDDDDDRRBRDDRDBDBBDDDBDDRDBBDDRDBB
DBDRDRDBDDDBBRDDRDDDDBDDDRDDDDDBBDRDBB
DBDRDRDBDJDBDBRDDBRDDDDRDDRDRRDDDDBDDD
BDDBRBRDDRDDDDBDDDJDDDBDRBDDDDDDBDBBDJ
BDDDBBRDDBDJDDDBRDDRDRDDDRDBRDDDDDDBDD
BDJDDDDRDBBDDRDBBRDDDDDDDRDBRDDDDDDBDD
DDRDDDDBDDDRDDDDDDRDRRDDDDDDBDDRDBDDDB
RDBBDDRDBBDDDBDDDDRDRRDDDDDDBDDRJDDRDD
BDDDRDDDDDDRDRJDDDDDDRDDDBBDDBRDDJDBDD
RRDDDBDDDDDRDRJDDDDDDBDDRDBJDJDRBDRDDD
OPTIONS:24,15,0