DDDDDDEDDJDREDDDDDRDRDDDDDDDEDDDDRDDDD
DRPRDDDDDDEDDDDDDDDDRJDDRDDDDEDDDDDEDD
DDDDDDDDDDEDDRDDDDDRDRDDRDDDDDDDDRDDDD
RDRRDDDDDDDDDRDDDDDDRDDRDDDDRDDDRDDDDD
RDERDDDDDDDDDERDDRDDDDDDDRDDDDDDDRDRRD
DDDEDDRDDDDDDDDRDDDDDRDERDDDDDDDDRDDRD
BBBBBBBBBBBBBBBBBBBBBBBBBBBBBBDDDRDDRD
DEDDDRDDJDEDDRDEDDDDDDDDDDJDRJDDDDDDED
DDJDDDDDRDDDDDEDDDDDDDDRRERDDRDDDDRDDD
DDDRDDRDRDDDDDDDDDDDDDDREDRDDRDDDDDDDD
DRDDDDDRDDDDDDDDRRRDDDDDDDRDDEDJDDDDRD
DJDDEDDRDEEDDDDDRDRJDDJDDDDDRDDDRDDJED
DERDDDDDDDDDDDDDDRERDDRDDDDDDDDDJDDDDR
DDDDDDDDBBBBBBBBBBBBBBBBBBBBBBBBBBBBBB
ERDDDDDDDDDRDDDJDDDDDRDDDDDRDDDRDDDDDD
ERDDDDDDDDDERDDRDDDDDDDDRDDDDDDRDRRDDX
DEDDRDDDDDDDDRDDDDDRDEEDDDDJDDDRDRRDDD
DDDDRJDDRDDDDDDDDRDDDDDDRDRJDDDDDDRDDD
DDDEDDRDEDDRDRRDDDDDDDDDRDRJDDDDDDEDDR
DJDDDDEDDDDDEDDDDDDDDDEDRDDRDDDDRDDDRD