ZZZZZZZZZZZZZZZZZZZZZZZZ
ZZZZPZZZBBBBBZZZBBZZZZZZ
ZZZZBBBZZZZBBBBZZZZZZZZZ
XXXXXXXXXXXXXXXXXXXXXXBB
ZZZZZZZZZBBBZZZZZBZZZZZZ
ZZZZZZZZZZZZZZZZZZZZZZZZ