DRDDRDDBDRDDDJDBDDDEDRDBRDDDDDDBDDRRDD
DDDDDDDBDDDDDDRBRRDEDDDBEDDJDDDBDDDDRD
EEEEEEEEEEEEEEEEEEEEEEEEEEEEEEEEEEEEEE
JDDDDDDBDRDDDDRBDRDEDDEBDDRDDJDBDDRDRD
DDDDDDDBDRDDDDRBDRDREDDBDDDDDRDBDDDEDD
BBBBBBBBBBBBBBBBBBBEBBBBBBBBBBBBBBBBBB
DDDDRRDBDDRDDDDBDDDEDDRBDDDDRDDBDDDDDR
DDDDDDDBDDEDDDDBDDDEDDDEDDDDRDEBDDDDDR
EEEEEEEEEEEEEEEEEEEEEEEEEEEEEEEEEEEEEE
RDDRDDDBDDDDRDDBDDREDDDBDDDDDDJBRDDDDD
RDDDDRDBDDRDDRDBDDDEDREBDDDDDDDBRDDDRD
DRDDDDDBDDDRDDDBDDDEDERBDDDDDDDBERDDRD
BBBBBBBBBBBBBBBBBBBEBBBBBBBBBBBBBBBBBB
RDEEEDDBDDDDRDRBDDDEDDDBDRJDDRDBDDDDDD
DDDDDRDBRDDDDDDBDDJEDDDBEDDRDDDBDRDRRD
EEEEEEEEEEEEEEEEEEEEEEEEEEEEEEEEEEEEEE
JDDEDRDBRDDDDRDBDRDEDDRBDRDRDDDBDDDDDD
DDDDDRDBRDDJDDDBDDDREDDBDDRDDDDBDDDRER
DJDDDERBDDRDDDDBDPJERDDBDEDDDDDBDDDRRE
DRDDDDEBDDEDDRDBDXDEDDDBDDDDRDRBDDDDED
OPTIONS:10,20,50